11111000001000010001100000011011
00011000001000000000110111111111
00011000001000000000110110000000
00011111111111111111111111111110
00110000001100000000000000000111
01100000001000000000110010011101
01000000000000000000111111110001
11111111111111100000000000000000
00011111111111111111111111111110
00011000001000000000110110000000
00011000001000000000110110000000
01110000000000000000111111110000
00110000001100000000000000000111
00110000001100000000000000000111
00110000001100000000000000000111
11111111111111100000000000000000
00011000001000010001100000011011
00011000001000000000110111111111
00011000001000000000110110000000
00011111111111111111111111111110
00110000001100000000000000000111
01100000001000000000110010011101
01000000000000000000111111110001
00011000001000010001100000011011
00011000001000000000110111111111
00011000001000000000110110000000
00011111111111111111111111111110
00110000001100000000000000000111
01100000001000000000110010011101
01000000000000000000111111110001
00011000001000010001100000011011
00011000001000000000110111111111

